"filename", "language", "C#", "XML", "comment", "blank", "total"
"/Users/bogz/Documents/sky-brigade/Horizon.Tests/Horizon.Tests.csproj", "XML", 0, 70, 0, 4, 74
"/Users/bogz/Documents/sky-brigade/Horizon.Tests/Program.cs", "C#", 15, 0, 0, 3, 18
"/Users/bogz/Documents/sky-brigade/Horizon.Tests/TestMenuGameScreen.cs", "C#", 94, 0, 4, 24, 122
"/Users/bogz/Documents/sky-brigade/Horizon.Tests/Tests/IEngineTest.cs", "C#", 12, 0, 0, 4, 16
"/Users/bogz/Documents/sky-brigade/Horizon.Tests/Tests/MeshLoadingEngineTest.cs", "C#", 107, 0, 12, 23, 142
"/Users/bogz/Documents/sky-brigade/Horizon.Tests/Tests/PIDController.cs", "C#", 32, 0, 0, 8, 40
"/Users/bogz/Documents/sky-brigade/Horizon.Tests/Tests/PIDTest.cs", "C#", 81, 0, 0, 16, 97
"/Users/bogz/Documents/sky-brigade/Horizon.Tests/Tests/PingPongGameTest.cs", "C#", 111, 0, 0, 27, 138
"/Users/bogz/Documents/sky-brigade/Horizon.Tests/Tests/PlanetGraphicsTest.cs", "C#", 89, 0, 6, 25, 120
"/Users/bogz/Documents/sky-brigade/Horizon.Tests/Tests/RenderRectangleEngineTest.cs", "C#", 42, 0, 0, 11, 53
"Total", "-", 583, 70, 22, 145, 820